SimpleFSM	KEYWORD1
Transition	KEYWORD1
TimedTransition	KEYWORD1
State	KEYWORD1
CallbackFunction	KEYWORD1
GuardCondition	KEYWORD1
add	KEYWORD2
setInitialState	KEYWORD2
setFinishedHandler	KEYWORD2
setTransitionHandler	KEYWORD2
trigger	KEYWORD2
run	KEYWORD2
reset	KEYWORD2
getState	KEYWORD2
getPreviousState	KEYWORD2
isInState	KEYWORD2
isFinished	KEYWORD2
lastTransitioned	KEYWORD2
getID	KEYWORD2
getName	KEYWORD2
setName	KEYWORD2
getDotDefinition	KEYWORD2
setOnRunHandler	KEYWORD2
setGuardCondition	KEYWORD2
getEventID	KEYWORD2
setup	KEYWORD2
setName	KEYWORD2
setOnRunHandler	KEYWORD2
setOnEnterHandler	KEYWORD2
setOnStateHandler	KEYWORD2
setOnExitHandler	KEYWORD2
setAsFinal	KEYWORD2
isFinal	KEYWORD2
getTimedTransitionCount	KEYWORD2
getTransitionCount	KEYWORD2